##################B#
#                  #
##### ##############
####  ###   ########
#### ###  ####  ####
# #  ###############
##  ### ############
#   ################
##    ##############
###  ###############
###   #### ###### ##
# # #####  #####  ##
# # ###   ##########
####      ##########
#    ###############
#  ##  #############
# ##################
    ################
 ###################
A###################